########################################
#**************************************#
#**************************************#
#**************************************#
#**************************************#
#**************************************#
#************###########***************#
#**************************************#
#**************************************#
#**************************************#
#**************************************#
#**************************************#
#**************************************#
#**************************************#
#**************************************#
#**************************************#
#****###########***********************#
#**************************************#
#**************************************#
#**************************************#
#**************************************#
#**************************************#
#**************************************#
#********************###########*******#
#**************************************#
#**************************************#
#**************************************#
#**************************************#
#*******###########********************#
#**************************************#
#**************************************#
#**************************************#
#**************************************#
#*****************###########**********#
#**************************************#
#**************************************#
#**************************************#
#**************************************#
#**************************************#
########################################
